Xv, Xv, Xv, Xv, Xv, Xv, Xv, Xv, Xv, Xv, Xv, Xv, Xv, Xv, Xv, Xv, Xv, Xv, Xv, Xv, Xv, Xv, Xv, Xv, Xv, Xv, Xv, Xv, Xv, Xv, Xv, Xv, Xv
Xv, Xv, Wo^Xo, Wo^Xo, Wo^Xo, Wo^Xo, Wo^Xo, Wo^Xo, Wo^Xo, Wo^Xo, Wo^Xo, Wo^Xo, Wo^Xo, Wo^Xo, Wo^Xo, Wo^Xo, Wo^Xo, Wo^Xo, Wo^Xo, Wo^Xo, Wo^Xo, Wo^Xo, Wo^Xo, Wo^Xo, Wo^Xo, Wo^Xo, Wo^Xo, Wo^Xo, Wo^Xo, Wo^Xo, Wo^Xo, Xv, Xv
Xv, Wo^Xo, Wo, Wwr, Wwr, Uh, Uu^Vu, Qlf, Qlf, Xu, Xu, Ai, Ms, Ms, Ms, Aa^Fpa, Aa, Aa, Ss, Ss, Ss, Wo, Aa, Aa^Fpa, Aa^Vea, Ha, Ms, Ms, Ms, Aa^Fpa, Ww^Vm, Wo^Xo, Xv
Xv, Wo^Xo, Wo, Ai, Ds, Uu^Tf, Uu^Tf, Ur, Uu, Uu, Xu, Ai, Aa^Vha, Ms, Ha, Ha, Rb^Tf, Aa^Fpa, Aa^Fpa, Ss^Vhs, Hh, Wwf, Wwf, Aa^Fpa, Aa, Wwf, Ha, Ms, Aa^Fpa, Ai, Ai, Wo^Xo, Xv
Xv, Wo^Xo, Wo, Ds, Dd^Do, Sm, Sm, Ur, Ur, Uh, Ai, Aa, Aa, Aa, Aa^Fpa, Rb, Rb, Rb^Tf, Aa, Hh, Rb, Wwr, Ai, Re, Re, Re, Re, Aa^Fpa, Ai, Ai, Ms, Wo^Xo, Xv
Xv, Wo^Xo, Ai, Dd, Dd, Dd, Mdd, Sm, Ds, Ds, Ai, Ai, Wwf, Aa^Fpa, Ha, Re, Re, Aa, Ms, Re, Re, Aa, Ww^Bw/, Re, Gs^Fms, Aa, Gg, Ai, Re, Aa^Fpa, Hh, Wo^Xo, Xv
Xv, Wo^Xo, Ai, Gs^Fms, Dd, Mdd, Mdd, Hd, Re, Ai, Ms, Wwf, Re^Tf, Re, Rb, Rb, Ias, Re, Hh, Re^Fet, Aa, Re, Ww, Ai, Wwf, Hh, Ai, Ai, Gg, Re, Gs^Vht, Wo^Xo, Xv
Xv, Wo^Xo, Ms, Aa^Fpa, Hh, Dd, Gg, Hd, Re, Aa^Fpa, Hh, Re^Tf, Aa, Re, Ias, Ch, Ch, Ias, Ias, Rb, Re, Re, Ms, Wo, Ds, Wwf, Ss, Aa^Fpa, Aa, Re, Aa, Wo^Xo, Xv
Xv, Wo^Xo, Aa^Fpa, Ha, Re^Tf, Aa, Gs^Fpa, Re, Ai, Ai, Re, Rb, Re, Ias, 3 Kh, Ch, Irs, Rrc^Vd, Ch, Ias, Aa, Hh, Aa^Fpa, Re, Ds, Ss^Vhs, Hh, Aa^Fpa, Re, Re, Xu, Wo^Xo, Xv
Xv, Wo^Xo, Hh, Re^Vc, Re^Tf, Gg, Re, Re, Re, Ww^Bw/, Wwf, Re, Aa, Ias, Ch, Irs, Kh, Irs, Ch, Ch, Rb, Re, Re, Re, Ai, Re, Re, Re, Uu, Uh, Xu, Wo^Xo, Xv
Xv, Wo^Xo, Aa, Re, Re, Re, Aa^Fpa, Hhd, Wwf, Ai, Ai, Re^Fms, Rb, Ch, Ch, Irs, Irs, Irs, 4 Kh, Ias, Ms, Gs^Fms, Re, Wwf, Wwf, Re, Re^Fetd, Ur, Ur, Qxu, Qxu, Wo^Xo, Xv
Xv, Wo^Xo, Gg^Fet, Gg, Gg, Aa, Ai, Wwf, Aa^Fpa, Ms, Rd, Ai, Re, Ias, Ias, Rrc^Vd, Ch, Ch, Ias, Ias, Hh, Aa^Fpa, Ww^Bw|, Ai, Ms, Ai, Wwf, Uu^Tf, Ur, Uu^Vud, Uh, Wo^Xo, Xv
Xv, Wo^Xo, Gll^Fp, Aa^Fpa, Ds, Ds, Ai, Rd, Rd, Hhd, Rd, Re, Ms, Rb, Rb, Ias, Ias, Ch, Rd^Tf, Rd, Ai, Wwf, Rr, Hh, Aa^Fpa, Wo, Ai, Uu^Tf, Ur, Uu, Wo, Wo^Xo, Xv
Xv, Wo^Xo, Hh, Ha, Ai, Ai, Qlf, Rd, Hd, Qlf, Dd, Rd, Wwf, Hhd, Rd^Ft, Aa, Re, Re^Fms, Ms, Ai, Rr, Rr, Aa, Rr, Rr, Aa, Gg, Wwf, Ds, Ds, Wo, Wo^Xo, Xv
Xv, Wo^Xo, Mm, Mm, Ai, Qlf, Ds, Rd, Hd, Qlf, Dd^Vda, Dd, Ai, Wwf, Aa^Fpa, Uu, Ur, Re, Ss^Bw\r, Ss, Rr, Gg, Gs^Ft, Gs^Ft, Dd, Rr, Rr, Ai, Wwr, Wwr, Wo, Wo^Xo, Xv
Xv, Wo^Xo, Aa^Fpa, Mm, Ai, Wwr, Wwr, Ds, Rd^Ft, Rd^Ft, Mv, Hd, Hd, Ai, Uu^Tf, Uu^Tf, Uu, Ss, Aa^Fpa, Rr, Dd, Hd, Md, Md, Dd^Do, Dd, Rr, Ai, Ai, Ai, Wo, Wo^Xo, Xv
Xv, Wo^Xo, Wo^Xo, Ai, Ww^Vm, Ai, Wo, Wo, Wo, Md, Md, Md, Rd^Ft, Qxu, Qxu, Uh, Ai, Ss, Hh, Dd, Dd^Vda, Dd, Dd^Dc, Md, Md, Dd, Rr, Ias^Vhc, Ai, Wo, Wo^Xo, Wo^Xo, Xv
Xv, Wo^Xo, Wo^Xo, Wo^Xo, Wo^Xo, Wo^Xo, Wo^Xo, Wo^Xo, Wo^Xo, Wo^Xo, Wo^Xo, Wo^Xo, Wo^Xo, Wo^Xo, Wo^Xo, Wo^Xo, Wo^Xo, Wo^Xo, Wo^Xo, Wo^Xo, Wo^Xo, Wo^Xo, Wo^Xo, Wo^Xo, Wo^Xo, Wo^Xo, Wo^Xo, Wo^Xo, Wo^Xo, Wo^Xo, Wo^Xo, Wo^Xo, Xv
Xv, Xv, Xv, Xv, Xv, Xv, Xv, Xv, Xv, Xv, Xv, Xv, Xv, Xv, Xv, Xv, Xv, Xv, Xv, Xv, Xv, Xv, Xv, Xv, Xv, Xv, Xv, Xv, Xv, Xv, Xv, Xv, Xv
