Xv, Xv, Xv, Xv, Xv, Xv, Xv, Xv, Xv, Xv, Xv, Xv, Xv, Xv, Xv, Xv, Xv, Xv, Xv, Xv, Xv, Xv, Xv, Xv, Xv, Xv, Xv, Xv, Xv, Xv, Xv, Xv, Xv
Xv, Xv, Wo^Xo, Wo^Xo, Wo^Xo, Wo^Xo, Wo^Xo, Wo^Xo, Wo^Xo, Wo^Xo, Wo^Xo, Wo^Xo, Wo^Xo, Wo^Xo, Wo^Xo, Wo^Xo, Wo^Xo, Wo^Xo, Wo^Xo, Wo^Xo, Wo^Xo, Wo^Xo, Wo^Xo, Wo^Xo, Wo^Xo, Wo^Xo, Wo^Xo, Wo^Xo, Wo^Xo, Wo^Xo, Wo^Xo, Xv, Xv
Xv, Wo^Xo, Ww, Wwr, Wwr, Uh, Uu^Vu, Qlf, Qlf, Xu, Xu, Wwf, Ms, Ms, Ms, Gg^Tf, Gg, Gg, Ss, Ss, Ss, Ww, Gg, Gg^Tf, Aa^Vea, Hh, Ms, Ms, Ms, Gg^Tf, Ww^Vm, Wo^Xo, Xv
Xv, Wo^Xo, Ww, Wwf, Ds, Uu^Tf, Uu^Tf, Ur, Uu, Uu, Xu, Wwf, Aa^Vha, Ms, Hh, Hh, Rb^Tf, Rb^Tf, Rb^Tf, Ss^Vhs, Hh, Wwf, Wwf, Gg^Tf, Gg, Wwf, Hh, Ms, Gg^Tf, Wwf, Wwf, Wo^Xo, Xv
Xv, Wo^Xo, Ww, Ds, Dd^Do, Sm, Sm, Ur, Ur, Uh, Wwf, Gg, Gg, Gg, Gg^Tf, Dd, Dd, Rb^Tf, Dd, Hh, Dd, Wwr, Wwf, Re, Re, Re, Re, Gg^Tf, Wwf, Wwf, Mm, Wo^Xo, Xv
Xv, Wo^Xo, Wwf, Dd, Dd, Dd, Mdd, Sm, Ds, Ds, Ww, Wwf, Wwf, Gg^Tf, Hh, Re, Re, Dd, Mm, Re, Re, Dd, Ww^Bw/, Re, Gs^Tf, Dd, Dd, Wwf, Re, Gs^Tf, Hh, Wo^Xo, Xv
Xv, Wo^Xo, Wwf, Dd^Tf, Dd, Mdd, Mdd, Hd, Re, Wwf, Mm, Wwf, Re^Tf, Re, Dd, Dd, Ias, Re, Hh, Re^Fet, Dd, Re, Wwf, Wwf, Wwf, Hh, Wwf, Wwf, Dd, Re, Gs^Vht, Wo^Xo, Xv
Xv, Wo^Xo, Mm, Dd^Tf, Hh, Dd, Dd, Hd, Re, Re^Tf, Hh, Re^Tf, Dd, Re, Ias, Ch, Ch, Ias, Ias, Dd, Re, Re, Mm, Ww, Ds, Wwf, Ss, Gs^Tf, Dd, Re, Dd, Wo^Xo, Xv
Xv, Wo^Xo, Gs^Tf, Hh, Re^Tf, Dd, Gs^Tf, Re, Wwf, Wwf, Re, Dd, Re, Ias, 3 Kh, Ch, Irs, Rrc^Vd, Ch, Ias, Dd, Hh, Re^Tf, Re, Ds, Ss^Vhs, Hh, Gs^Tf, Re, Re, Xu, Wo^Xo, Xv
Xv, Wo^Xo, Hh, Re^Vc, Re^Tf, Dd, Re, Re, Re, Ww^Bw/, Wwf, Re, Dd, Ias, Ch, Irs, Kh, Irs, Ch, Ch, Dd, Re, Re, Re, Wwf, Re, Re, Re, Uu, Uh, Xu, Wo^Xo, Xv
Xv, Wo^Xo, Dd, Re, Re, Re, Gs^Tf, Hhd, Wwf, Wo, Wwf, Re^Tf, Dd, Ch, Ch, Irs, Irs, Irs, 4 Kh, Ias, Mm, Gs^Tf, Re, Wwf, Wwf, Re, Re^Fetd, Ur, Ur, Qxu, Qxu, Wo^Xo, Xv
Xv, Wo^Xo, Gg^Fet, Dd, Dd, Dd, Wwf, Wwf, Rd^Tf, Mm, Dd, Wwf, Re, Ias, Ias, Rrc^Vd, Ch, Ch, Ias, Ias, Hh, Gs^Tf, Ww^Bw|, Wwf, Mm, Wwf, Wwf, Uu^Tf, Ur, Uu^Vud, Uh, Wo^Xo, Xv
Xv, Wo^Xo, Gll^Tf, Gll^Tf, Ds, Ds, Wwf, Dd, Dd, Hhd, Dd, Re, Mm, Dd, Dd, Ias, Ias, Ch, Rd^Tf, Rd, Wwf, Wwf, Rr, Hh, Gs^Tf, Ww, Wwf, Uu^Tf, Ur, Uu, Ww, Wo^Xo, Xv
Xv, Wo^Xo, Hh, Hh, Wwf, Wwf, Qlf, Dd, Hd, Qlf, Dd, Dd, Wwf, Hhd, Rd^Tf, Dd, Re, Re^Tf, Mm, Wwf, Rr, Rr, Dd, Rr, Rr, Dd, Dd, Wwf, Ds, Ds, Ww, Wo^Xo, Xv
Xv, Wo^Xo, Mm, Mm, Wwf, Qlf, Ds, Dd, Hd, Qlf, Dd^Vda, Dd, Wwf, Wwf, Rd^Tf, Uu, Ur, Re, Ss^Bw\r, Ss, Rr, Dd, Gs^Tf, Gs^Tf, Dd, Rr, Rr, Wwf, Wwr, Wwr, Ww, Wo^Xo, Xv
Xv, Wo^Xo, Gs^Tf, Mm, Wwf, Wwr, Wwr, Ds, Rd^Tf, Rd^Tf, Mv, Hd, Hd, Wwf, Uu^Tf, Uu^Tf, Uu, Ss, Gs^Tf, Rr, Dd, Hd, Md, Md, Dd^Do, Dd, Rr, Wwf, Wwf, Wwf, Ww, Wo^Xo, Xv
Xv, Wo^Xo, Wo^Xo, Wwf, Ww^Vm, Wwf, Ww, Ww, Ww, Md, Md, Md, Rd^Tf, Qxu, Qxu, Uh, Ww, Ss, Hh, Dd, Dd^Vda, Dd, Dd^Dc, Md, Md, Dd, Rr, Ias^Vhc, Wwf, Ww, Wo^Xo, Wo^Xo, Xv
Xv, Wo^Xo, Wo^Xo, Wo^Xo, Wo^Xo, Wo^Xo, Wo^Xo, Wo^Xo, Wo^Xo, Wo^Xo, Wo^Xo, Wo^Xo, Wo^Xo, Wo^Xo, Wo^Xo, Wo^Xo, Wo^Xo, Wo^Xo, Wo^Xo, Wo^Xo, Wo^Xo, Wo^Xo, Wo^Xo, Wo^Xo, Wo^Xo, Wo^Xo, Wo^Xo, Wo^Xo, Wo^Xo, Wo^Xo, Wo^Xo, Wo^Xo, Xv
Xv, Xv, Xv, Xv, Xv, Xv, Xv, Xv, Xv, Xv, Xv, Xv, Xv, Xv, Xv, Xv, Xv, Xv, Xv, Xv, Xv, Xv, Xv, Xv, Xv, Xv, Xv, Xv, Xv, Xv, Xv, Xv, Xv
