Xv, Xv, Xv, Xv, Xv, Xv, Xv, Xv, Xv, Xv, Xv, Xv, Xv, Xv, Xv, Xv, Xv, Xv, Xv, Xv, Xv, Xv, Xv, Xv, Xv, Xv, Xv, Xv, Xv, Xv, Xv, Xv, Xv
Xv, Xv, Wo^Xo, Wo^Xo, Wo^Xo, Wo^Xo, Wo^Xo, Wo^Xo, Wo^Xo, Wo^Xo, Wo^Xo, Wo^Xo, Wo^Xo, Wo^Xo, Wo^Xo, Wo^Xo, Wo^Xo, Wo^Xo, Wo^Xo, Wo^Xo, Wo^Xo, Wo^Xo, Wo^Xo, Wo^Xo, Wo^Xo, Wo^Xo, Wo^Xo, Wo^Xo, Wo^Xo, Wo^Xo, Wo^Xo, Xv, Xv
Xv, Wo^Xo, Wo, Wwr, Wwr, Uh, Uu^Vu, Qlf, Qlf, Xu, Xu, Ai, Ms, Ms, Ms, Aa^Fpa, Aa, Aa, Ss, Ss, Ss, Wo, Aa, Aa^Fpa, Aa^Vea, Ha, Ms, Ms, Ms, Aa^Fpa, Wo, Wo^Xo, Xv
Xv, Wo^Xo, Wo, Wo, Wwr, Uu^Tf, Uu^Tf, Wwf, Uu, Uu, Xu, Ai, Aa^Vha, Ms, Ha, Ha, Rb^Tf, Rb^Fms, Rb^Fms, Ss^Vhs, Hh, Ww, Ww, Aa^Fpa, Aa, Ww, Ha, Ms, Aa^Fpa, Ai, Wo, Wo^Xo, Xv
Xv, Wo^Xo, Wo, Wwr, Dd^Do, Sm, Sm, Wwf, Wwf, Uh, Ai, Aa, Aa, Aa, Aa^Fpa, Wwf, Wwf, Rb^Tf, Wwf, Hh, Wwf, Wwr, Wo, Wwf, Wwf, Wwf, Wwf, Aa^Fpa, Wo, Wo, Mm, Wo^Xo, Xv
Xv, Wo^Xo, Wo, Dd, Dd, Dd, Mdd, Sm, Wwr, Wwr, Wo, Ai, Ww, Aa^Fpa, Ha, Wwf, Wwf, Wwf, Mm, Wwf, Wwf, Wwf, Ww, Wwf, Gs^Fms, Wwf, Wwf, Wo, Wwf, Gs^Fms, Hh, Wo^Xo, Xv
Xv, Wo^Xo, Wo, Gs^Fms, Dd, Mdd, Mdd, Hd, Wwf, Wo, Mm, Ww, Re^Tf, Wwf, Wwf, Wwf, Ias, Wwf, Hh, Re^Fet, Wwf, Wwf, Wo, Wo, Ww, Hh, Wo, Wo, Wwf, Wwf, Gs^Vht, Wo^Xo, Xv
Xv, Wo^Xo, Mm, Gs^Fms, Hh, Dd, Wwf, Hd, Wwf, Re^Fms, Hh, Re^Vct, Wwf, Wwf, Ias, Ch, Ch, Ias, Ias, Wwf, Wwf, Wwf, Mm, Wo, Wwr, Ww, Ss, Gs^Ft, Wwf, Wwf, Wwf, Wo^Xo, Xv
Xv, Wo^Xo, Gs^Fms, Hh, Re^Tf, Wwf, Gs^Fms, Wwf, Wo, Wo, Wwf, Wwf, Wwf, Ias, 3 Kh, Ch, Irs, Rrc^Vd, Ch, Ias, Wwf, Hh, Re^Fms, Wwf, Wwr, Ss^Vhs, Hh, Gs^Ft, Wwf, Wwf, Xu, Wo^Xo, Xv
Xv, Wo^Xo, Hh, Re^Vc, Re^Tf, Wwf, Wwf, Wwf, Wwf, Ww, Ww, Wwf, Wwf, Ias, Ch, Irs, Kh, Irs, Ch, Ch, Wwf, Wwf, Wwf, Wwf, Wo, Wwf, Wwf, Wwf, Uu, Uh, Xu, Wo^Xo, Xv
Xv, Wo^Xo, Wwf, Wwf, Wwf, Wwf, Gs^Fms, Hhd, Ww, Wo, Wo, Re^Fms, Wwf, Ch, Ch, Irs, Irs, Irs, 4 Kh, Ias, Mm, Gs^Fms, Wwf, Ww, Ww, Wwf, Re^Fetd, Wwf, Wwf, Qxu, Qxu, Wo^Xo, Xv
Xv, Wo^Xo, Gg^Fet, Wwf, Wwf, Wwf, Wo, Ww, Rd^Ft, Mm, Wwr, Wo, Wwf, Ias, Ias, Rrc^Vd, Ch, Ch, Ias, Ias, Hh, Gs^Fms, Ww, Wo, Mm, Ww, Ww, Uu^Tf, Wwf, Uu^Vud, Uh, Wo^Xo, Xv
Xv, Wo^Xo, Gll^Fp, Gll^Fp, Wwr, Wwr, Wo, Wwr, Wwr, Hhd, Wwr, Wwf, Mm, Wwf, Wwf, Ias, Ias, Ch, Rd^Tf, Wwf, Wo, Ww, Wwf, Hh, Gs^Fms, Wo, Wo, Uu^Tf, Wwf, Uu, Wo, Wo^Xo, Xv
Xv, Wo^Xo, Hh, Hh, Wo, Wo, Qlf, Wwr, Hd, Qlf, Dd, Wwr, Wo, Hhd, Rd^Ft, Wwf, Wwf, Re^Fms, Mm, Wo, Wwf, Wwf, Wwf, Wwf, Wwf, Wwf, Wwf, Ww, Wwr, Wwr, Wo, Wo^Xo, Xv
Xv, Wo^Xo, Mm, Mm, Wo, Qlf, Ds, Wwr, Hd, Qlf, Dd^Vda, Dd, Wo, Wo, Rd^Ft, Uu, Ur, Wwf, Ss^Bw\r, Ss, Wwf, Wwf, Gs^Ft, Gs^Ft, Wwr, Wwf, Wwf, Wo, Ww, Ww, Wo, Wo^Xo, Xv
Xv, Wo^Xo, Gs^Fms, Mm, Wo, Wwr, Wwr, Ds, Rd^Ft, Rd^Ft, Mv, Hd, Hd, Wo, Uu^Tf, Uu^Tf, Uu, Ss, Gs^Ft, Wwf, Wwr, Hd, Md, Md, Dd^Do, Wwr, Wwf, Wo, Wo, Wo, Wo, Wo^Xo, Xv
Xv, Wo^Xo, Wo^Xo, Wo, Ww^Vm, Wo, Wo, Wo, Wo, Md, Md, Md, Rd^Ft, Qxu, Qxu, Uh, Wo, Ss, Hh, Wwr, Dd^Vda, Dd, Wwr, Md, Md, Dd, Wwf, Ias^Vhc, Wo, Wo, Wo^Xo, Wo^Xo, Xv
Xv, Wo^Xo, Wo^Xo, Wo^Xo, Wo^Xo, Wo^Xo, Wo^Xo, Wo^Xo, Wo^Xo, Wo^Xo, Wo^Xo, Wo^Xo, Wo^Xo, Wo^Xo, Wo^Xo, Wo^Xo, Wo^Xo, Wo^Xo, Wo^Xo, Wo^Xo, Wo^Xo, Wo^Xo, Wo^Xo, Wo^Xo, Wo^Xo, Wo^Xo, Wo^Xo, Wo^Xo, Wo^Xo, Wo^Xo, Wo^Xo, Wo^Xo, Xv
Xv, Xv, Xv, Xv, Xv, Xv, Xv, Xv, Xv, Xv, Xv, Xv, Xv, Xv, Xv, Xv, Xv, Xv, Xv, Xv, Xv, Xv, Xv, Xv, Xv, Xv, Xv, Xv, Xv, Xv, Xv, Xv, Xv
