Xv, Xv, Xv, Xv, Xv, Xv, Xv, Xv, Xv, Xv, Xv, Xv, Xv, Xv, Xv, Xv, Xv, Xv, Xv, Xv, Xv, Xv, Xv, Xv, Xv, Xv, Xv, Xv, Xv, Xv, Xv, Xv, Xv
Xv, Xv, Wo^Xo, Wo^Xo, Wo^Xo, Wo^Xo, Wo^Xo, Wo^Xo, Wo^Xo, Wo^Xo, Wo^Xo, Wo^Xo, Wo^Xo, Wo^Xo, Wo^Xo, Wo^Xo, Wo^Xo, Wo^Xo, Wo^Xo, Wo^Xo, Wo^Xo, Wo^Xo, Wo^Xo, Wo^Xo, Wo^Xo, Wo^Xo, Wo^Xo, Wo^Xo, Wo^Xo, Wo^Xo, Wo^Xo, Xv, Xv
Xv, Wo^Xo, Wo, Wwr, Wwr, Uh, Uu^Vu, Qlf, Qlf, Xu, Xu, Ai, Ms, Ms, Ms, Aa^Fpa, Aa, Aa, Ss, Ss, Ss, Wo, Aa, Aa^Fpa, Aa^Vea, Ha, Ms, Ms, Ms, Aa^Fpa, Wo, Wo^Xo, Xv
Xv, Wo^Xo, Wo, Ai, Ds, Uu^Tf, Uu^Tf, Ur, Uu, Uu, Xu, Ai, Aa^Vha, Ms, Ha, Ha, Rb^Tf, Aa^Fpa, Aa^Fpa, Ss^Vhs, Ha, Wwf, Wwf, Aa^Fpa, Aa, Wwf, Ha, Ms, Aa^Fpa, Ai, Ai, Wo^Xo, Xv
Xv, Wo^Xo, Wo, Ds, Dd^Do, Sm, Sm, Ur, Ur, Uh, Ai, Aa, Aa, Aa, Aa^Fpa, Aa, Aa, Rb^Tf, Aa, Ha, Aa, Wwr, Ai, Re, Re, Re, Re, Aa^Fpa, Ai, Ai, Ms, Wo^Xo, Xv
Xv, Wo^Xo, Ai, Dd, Dd, Dd, Mdd, Sm, Ds, Ds, Ai, Ai, Wwf, Aa^Fpa, Ha, Re, Re, Aa, Ms, Re, Re, Aa, Ww^Bw/, Re, Aa^Fpa, Aa, Aa, Ai, Re, Aa^Fpa, Ha, Wo^Xo, Xv
Xv, Wo^Xo, Ai, Aa^Fpa, Dd, Mdd, Mdd, Hd, Re, Ai, Ms, Wwf, Re^Tf, Re, Aa, Aa, Ias, Re, Ha, Aa^Fet, Aa, Re, Ai, Ai, Wwf, Ha, Ai, Ai, Aa, Re, Aa^Vht, Wo^Xo, Xv
Xv, Wo^Xo, Ms, Aa^Fpa, Ha, Dd, Aa, Hd, Re, Aa^Fpa, Ha, Re^Vct, Aa, Re, Ias, Ch, Ch, Ias, Ias, Aa, Re, Re, Ms, Wo, Ds, Wwf, Ss, Aa^Fpa, Aa, Re, Aa, Wo^Xo, Xv
Xv, Wo^Xo, Aa^Fpa, Ha, Re^Tf, Aa, Aa^Fpa, Re, Ai, Ai, Re, Aa, Re, Ias, 3 Kh, Ch, Irs, Rrc^Vd, Ch, Ias, Aa, Ha, Aa^Fpa, Re, Ds, Ss^Vhs, Ha, Aa^Fpa, Re, Re, Xu, Wo^Xo, Xv
Xv, Wo^Xo, Ha, Aa^Vc, Re^Tf, Aa, Re, Re, Re, Ww^Bw/, Wwf, Re, Aa, Ias, Ch, Irs, Kh, Irs, Ch, Ch, Aa, Re, Re, Re, Ai, Re, Aa, Aa, Uu, Uh, Xu, Wo^Xo, Xv
Xv, Wo^Xo, Aa, Re, Re, Re, Aa^Fpa, Ha, Wwf, Ai, Ai, Aa^Fpa, Aa, Ch, Ch, Irs, Irs, Irs, 4 Kh, Ias, Ms, Aa^Fpa, Re, Wwf, Wwf, Re, Aa^Fetd, Ur, Ur, Qxu, Qxu, Wo^Xo, Xv
Xv, Wo^Xo, Aa^Fet, Aa, Aa, Aa, Ai, Wwf, Aa^Fpa, Ms, Rd, Ai, Re, Ias, Ias, Rrc^Vd, Ch, Ch, Ias, Ias, Ha, Aa^Fpa, Ww^Bw|, Ai, Ms, Ai, Wwf, Uu^Tf, Ur, Uu^Vud, Uh, Wo^Xo, Xv
Xv, Wo^Xo, Aa^Fpa, Aa^Fpa, Ds, Ds, Ai, Rd, Rd, Ha, Rd, Re, Ms, Aa, Aa, Ias, Ias, Ch, Rd^Tf, Rd, Ai, Wwf, Rr, Ha, Aa^Fpa, Wo, Ai, Uu^Tf, Ur, Uu, Wo, Wo^Xo, Xv
Xv, Wo^Xo, Ha, Ha, Ai, Ai, Qlf, Rd, Hd, Qlf, Dd, Rd, Wwf, Ha, Aa^Fpa, Aa, Re, Aa^Fpa, Ms, Ai, Rr, Rr, Aa, Rr, Rr, Aa, Aa, Wwf, Ds, Ds, Wo, Wo^Xo, Xv
Xv, Wo^Xo, Ms, Ms, Ai, Qlf, Ds, Rd, Hd, Qlf, Dd^Vda, Dd, Ai, Wwf, Aa^Fpa, Uu, Ur, Re, Ss^Bw\r, Ss, Rr, Aa, Aa^Fpa, Aa^Fpa, Dd, Rr, Rr, Ai, Wwr, Wwr, Wo, Wo^Xo, Xv
Xv, Wo^Xo, Aa^Fpa, Ms, Ai, Wwr, Wwr, Ds, Rd^Ft, Rd^Ft, Mv, Hd, Hd, Ai, Uu^Tf, Uu^Tf, Uu, Ss, Aa^Fpa, Rr, Dd, Hd, Md, Md, Dd^Do, Dd, Rr, Ai, Ai, Ai, Wo, Wo^Xo, Xv
Xv, Wo^Xo, Wo^Xo, Ai, Ww^Vm, Ai, Wo, Wo, Wo, Md, Md, Md, Rd^Ft, Qxu, Qxu, Uh, Ai, Ss, Ha, Dd, Dd^Vda, Dd, Dd^Dc, Md, Md, Dd, Rr, Ias^Vhc, Ai, Wo, Wo^Xo, Wo^Xo, Xv
Xv, Wo^Xo, Wo^Xo, Wo^Xo, Wo^Xo, Wo^Xo, Wo^Xo, Wo^Xo, Wo^Xo, Wo^Xo, Wo^Xo, Wo^Xo, Wo^Xo, Wo^Xo, Wo^Xo, Wo^Xo, Wo^Xo, Wo^Xo, Wo^Xo, Wo^Xo, Wo^Xo, Wo^Xo, Wo^Xo, Wo^Xo, Wo^Xo, Wo^Xo, Wo^Xo, Wo^Xo, Wo^Xo, Wo^Xo, Wo^Xo, Wo^Xo, Xv
Xv, Xv, Xv, Xv, Xv, Xv, Xv, Xv, Xv, Xv, Xv, Xv, Xv, Xv, Xv, Xv, Xv, Xv, Xv, Xv, Xv, Xv, Xv, Xv, Xv, Xv, Xv, Xv, Xv, Xv, Xv, Xv, Xv
