Xv, Xv, Xv, Xv, Xv, Xv, Xv, Xv, Xv, Xv, Xv, Xv, Xv, Xv, Xv, Xv, Xv, Xv, Xv, Xv, Xv, Xv, Xv, Xv, Xv, Xv, Xv, Xv, Xv, Xv, Xv, Xv, Xv
Xv, Xv, Wo^Xo, Wo^Xo, Wo^Xo, Wo^Xo, Wo^Xo, Wo^Xo, Wo^Xo, Wo^Xo, Wo^Xo, Wo^Xo, Wo^Xo, Wo^Xo, Wo^Xo, Wo^Xo, Wo^Xo, Wo^Xo, Wo^Xo, Wo^Xo, Wo^Xo, Wo^Xo, Wo^Xo, Wo^Xo, Wo^Xo, Wo^Xo, Wo^Xo, Wo^Xo, Wo^Xo, Wo^Xo, Wo^Xo, Xv, Xv
Xv, Wo^Xo, Wo, Wwr, Wwr, Uh, Uu^Vu, Qlf, Qlf, Xu, Xu, Ai, Ms, Ms, Ms, Aa^Fpa, Aa, Aa, Ss, Ss, Ss, Wo, Aa, Aa^Fpa, Aa^Vea, Ha, Ms, Ms, Ms, Aa^Fpa, Wo, Wo^Xo, Xv
Xv, Wo^Xo, Wo, Wwt, Ds, Uu^Tf, Uu^Tf, Ur, Uu, Uu, Xu, Ai, Aa^Vha, Ms, Ha, Ha, Rb^Tf, Rb^Fms, Rb^Fms, Ss^Vhs, Hh, Wwf, Wwf, Aa^Fpa, Aa, Wwf, Ha, Ms, Aa^Fpa, Ai, Wwt, Wo^Xo, Xv
Xv, Wo^Xo, Wo, Ds, Dd^Do, Sm, Sm, Ur, Ur, Uh, Ai, Aa, Aa, Aa, Aa^Fpa, Rb, Rb, Rb^Tf, Rb, Hh, Rb, Wwr, Wwt, Re, Re, Re, Re, Aa^Fpa, Wwt, Wwt, Mm, Wo^Xo, Xv
Xv, Wo^Xo, Ww, Dd, Dd, Dd, Mdd, Sm, Ds, Ds, Wo, Ai, Wwf, Aa^Fpa, Ha, Re, Re, Rb, Mm, Re, Re, Rb, Ww^Bw/, Re, Gs^Fms, Gg, Gg, Wwt, Re, Gs^Fms, Hh, Wo^Xo, Xv
Xv, Wo^Xo, Ww, Gs^Fms, Dd, Mdd, Mdd, Hd, Re, Wwt, Mm, Wwf, Re^Tf, Re, Rb, Rb, Ias, Re, Hh, Re^Fet, Rb, Re, Ww, Wwt, Wwf, Hh, Wwt, Wwt, Gg, Re, Gs^Vht, Wo^Xo, Xv
Xv, Wo^Xo, Mm, Gs^Fms, Hh, Dd, Gg, Hd, Re, Re^Fms, Hh, Re^Vct, Rb, Re, Ias, Ch, Ch, Ias, Ias, Rb, Re, Re, Mm, Wo, Ds, Wwf, Ss, Gs^Ft, Gg, Re, Gg, Wo^Xo, Xv
Xv, Wo^Xo, Gs^Fms, Hh, Re^Tf, Gg, Gs^Fms, Re, Wwt, Wwt, Re, Rb, Re, Ias, 3 Kh, Ch, Irs, Rrc^Vd, Ch, Ias, Rb, Hh, Re^Fms, Re, Ds, Ss^Vhs, Hh, Gs^Ft, Re, Re, Xu, Wo^Xo, Xv
Xv, Wo^Xo, Hh, Re^Vc, Re^Tf, Gg, Re, Re, Re, Ww^Bw/, Wwf, Re, Rb, Ias, Ch, Irs, Kh, Irs, Ch, Ch, Rb, Re, Re, Re, Ww, Re, Re, Re, Uu, Uh, Xu, Wo^Xo, Xv
Xv, Wo^Xo, Gg, Re, Re, Re, Gs^Fms, Hhd, Wwf, Wo, Wwt, Re^Fms, Rb, Ch, Ch, Irs, Irs, Irs, 4 Kh, Ias, Mm, Gs^Fms, Re, Wwf, Wwf, Re, Re^Fetd, Ur, Ur, Qxu, Qxu, Wo^Xo, Xv
Xv, Wo^Xo, Gg^Fet, Gg, Gg, Gg, Wwt, Wwf, Rd^Ft, Mm, Rd, Wwt, Re, Ias, Ias, Rrc^Vd, Ch, Ch, Ias, Ias, Hh, Gs^Fms, Ww^Bw|, Wwt, Mm, Ww, Wwf, Uu^Tf, Ur, Uu^Vud, Uh, Wo^Xo, Xv
Xv, Wo^Xo, Gll^Fp, Gll^Fp, Ds, Ds, Wwt, Rd, Rd, Hhd, Rd, Re, Mm, Rb, Rb, Ias, Ias, Ch, Rd^Tf, Rd, Wwt, Wwf, Rr, Hh, Gs^Fms, Wo, Wwt, Uu^Tf, Ur, Uu, Wo, Wo^Xo, Xv
Xv, Wo^Xo, Hh, Hh, Wwt, Wwt, Qlf, Rd, Hd, Qlf, Dd, Rd, Wwf, Hhd, Rd^Ft, Rb, Re, Re^Fms, Mm, Wwt, Rr, Rr, Gg, Rr, Rr, Gg, Gg, Wwf, Ds, Ds, Wo, Wo^Xo, Xv
Xv, Wo^Xo, Mm, Mm, Wwt, Qlf, Ds, Rd, Hd, Qlf, Dd^Vda, Dd, Ww, Wwf, Rd^Ft, Uu, Ur, Re, Ss^Bw\r, Ss, Rr, Gg, Gs^Ft, Gs^Ft, Dd, Rr, Rr, Wwt, Wwr, Wwr, Wo, Wo^Xo, Xv
Xv, Wo^Xo, Gs^Fms, Mm, Wwt, Wwr, Wwr, Ds, Rd^Ft, Rd^Ft, Mv, Hd, Hd, Ww, Uu^Tf, Uu^Tf, Uu, Ss, Gs^Ft, Rr, Dd, Hd, Md, Md, Dd^Do, Dd, Rr, Wwt, Wwt, Ww, Wo, Wo^Xo, Xv
Xv, Wo^Xo, Wo^Xo, Wwt, Ww^Vm, Wwt, Wo, Wo, Wo, Md, Md, Md, Rd^Ft, Qxu, Qxu, Uh, Wo, Ss, Hh, Dd, Dd^Vda, Dd, Dd^Dc, Md, Md, Dd, Rr, Ias^Vhc, Wwt, Wo, Wo^Xo, Wo^Xo, Xv
Xv, Wo^Xo, Wo^Xo, Wo^Xo, Wo^Xo, Wo^Xo, Wo^Xo, Wo^Xo, Wo^Xo, Wo^Xo, Wo^Xo, Wo^Xo, Wo^Xo, Wo^Xo, Wo^Xo, Wo^Xo, Wo^Xo, Wo^Xo, Wo^Xo, Wo^Xo, Wo^Xo, Wo^Xo, Wo^Xo, Wo^Xo, Wo^Xo, Wo^Xo, Wo^Xo, Wo^Xo, Wo^Xo, Wo^Xo, Wo^Xo, Wo^Xo, Xv
Xv, Xv, Xv, Xv, Xv, Xv, Xv, Xv, Xv, Xv, Xv, Xv, Xv, Xv, Xv, Xv, Xv, Xv, Xv, Xv, Xv, Xv, Xv, Xv, Xv, Xv, Xv, Xv, Xv, Xv, Xv, Xv, Xv
